NNNNBBBBBBBBBBBNNNN
NNNBB    S    BBNNN
NNBBR          BBNN
NBB             BBN
BB               BB
B                 B
B                 B
B      BBBBB      B
B     B  E  B     B
BB    B     B    BB
NBB             BBN
NNBB           BBNN
NNNBB        RBBNNN
NNNNBBBBBBBBBBBNNNN