BBBBBBBBBBBBBB
B            B
B  R         B
B    B S     B
BE  BB       B
BBBBBBBBBBBBBB