BBBBBBBBBBBBBB
B            B
B  R         B
B    B S     B
B   BB       B
BBBBBBBBBBBBBB