BBBBBBBBBBBBBBBBBBBBBB
B      B      B      B
B  S      R          B
B      B      B      B
BBB  BBBBB  BBBBB  BBB
B      B      B      B
B             R     EB
B      B      B      B
BBB  BBBBB  BBBBB  BBB
B      B      B      B
B                    B
B      B      B      B
BBBBBBBBBBBBBBBBBBBBBB