BBBBBBBBBBBBBBBBB
B               B
B               B
B     BBBBB     B
B     BNNNB     B
B     BNNNB     B
B  S  BNNNB     B
B     BNNNB     B
B  R  BNNNB  E  B
BBBBBBBNNNBBBBBBB