BBBBBBBBBBBBBBBBBBBB
B R      BB      E B
B        B         B
B   B             BB
B  BB  S         BBB
BBBBBBBBBBBBBBBBBBBB